################################
#..............................#
#..............................#
#..............................#
#..............................#
#.......#################......#
#.......#...............#......#
#.......#...............#......#
#.......#...............#......#
#.......#...............#......#
#.......########.....####......#
#..............................#
#..............................#
#.......###############........#
#..............................#
#.......###############........#
#..............................#
#..............................#
#..............................#
#..............................#
#.........##############.......#
#.........##############.......#
#..............................#
#..............................#
#..............................#
#..............................#
#..............................#
#..............................#
#..............................#
#..............................#
#..............................#
################################