################################
#..............................#
#..............................#
#..............................#
#..............................#
#.......#################......#
#.......................#......#
#.......................#......#
#.......................#......#
#.......................#......#
#............###........#......#
#..............................#
#..............................#
#..............................#
#..............................#
#..............................#
#..............................#
#..............................#
#..............................#
#..............................#
#.........##############.......#
#.........##############.......#
#..............................#
#..............................#
#..............................#
#..............................#
#..............................#
#..............................#
#..............................#
#..............................#
#..............................#
################################